10
...wwww...
..t.ww..c.
f.c..ft...
..t....w..
ff..t..f.t
t.www..cf.