10
...wwww...
..t.ww....
f....ft...
..t....w..
ff..t..f.t
t.www...f.